XXXXXXXXXXXXXXXXXXXXXX
Xd2213212131123211112X
X23322XXX11X52X211321X
X12212XXXXXXX11111111X
XXXXXXXXXXXXXXXX41211X
XX2111X21613X33311233X
XaX112X1311X33XX12112X
XXX21XX1111X111111211X
X222121XX22X111b11111X
X222111X231X1122122c2X
X111112X132X122313233X
XXXXXXXXXXXXXXXXXXXXXX
